20 20

4 4 4 4 4 4 4 4 4 4 4 4 4 4 4 4 4 4 4 4
4 0 0 0 0 0 0 0 0 0 0 0 0 0 0 0 0 0 0 4
4 0 0 0 0 0 0 0 0 0 0 0 0 0 0 0 0 0 0 4
4 0 1 0 0 0 1 0 0 0 0 1 0 1 0 0 0 0 1 4
4 0 0 0 1 0 0 0 1 0 0 0 0 0 0 1 0 0 0 4
4 0 0 0 0 0 0 0 0 0 0 0 0 0 0 0 0 0 0 4
4 0 0 0 0 0 0 0 0 0 0 0 0 0 0 0 0 0 0 4
4 2 2 2 2 2 2 2 2 2 2 2 2 2 2 2 2 2 2 4
4 3 3 3 3 3 3 3 3 3 3 3 3 3 3 3 3 3 3 4
4 3 3 3 3 3 3 3 3 3 3 3 3 3 3 3 3 3 3 4
4 3 3 3 3 3 3 3 3 3 3 3 3 3 3 3 3 3 3 4
4 3 3 3 3 3 3 3 3 3 3 3 3 3 3 3 3 3 3 4
4 3 3 3 3 3 3 3 3 3 3 3 3 3 3 3 3 3 3 4
4 3 3 3 3 3 3 3 3 3 3 3 3 3 3 3 3 3 3 4
4 3 3 3 3 3 3 3 3 3 3 3 3 3 3 3 3 3 3 4
4 3 3 3 3 3 3 3 3 3 3 3 3 3 3 3 3 3 3 4
4 3 3 3 3 3 3 3 3 3 3 3 3 3 3 3 3 3 3 4
4 3 3 3 3 3 3 3 3 3 3 3 3 3 3 3 3 3 3 4
4 3 3 3 3 3 3 3 3 3 3 3 3 3 3 3 3 3 3 4
4 4 4 4 4 4 4 4 4 4 4 4 4 4 4 4 4 4 4 4